{
    "background":[
        {"src": "img/testbckgrnd.jpg"}
    ],
    "middleground":[
        {"src": "img/testfore.png"}
    ],

	"Map":[
		{"RowData" : "0000000000000000000000000000000000000000000000000000000000000000000000000000000000000000000000000000"},
		{"RowData" : "0000000000000000001000000000000000000000000000000000000000000000000000000000000000000000000000000000"},
		{"RowData" : "0000000000000000011110000000000000000000000000000000100000000000000000000000000000001111111111000000"},
		{"RowData" : "0000000000000000111110000000000000000000000000000001100000000000000000000000000011111111111111000000"},
		{"RowData" : "0000000000000111111111100000000000000000000000000011100000000000000000000000001111111111111111000001"},
		{"RowData" : "0000000000001111111111111000000000000000000000000111100000000000000000000000001111111111111111000001"},
		{"RowData" : "0000000000111111111111111111111000000000000000001111100000000000000000000000001111111111111111000001"},
		{"RowData" : "0000001111111111111111111111111110000000000000011111100000000000000000000000001111111111111111000001"},
		{"RowData" : "1111111111111111111111111111111111111111111111111111111111111111111111111111111111111111111111111111"},
		{"RowData" : "1111111111111111111111111111111111111111111111111111111111111111111111111111111111111111111111111111"}
]
}
